11111111111111111111111111111111111111111111111111111111111111
10000000000000000000000000000000000000000000000000000000000001
10000000011111100000000110001110000011001111110011111000000001
1000000111C0001100111C011000011000001100100000011C001100000001
10000000110000110000000110000110010011000111100000001100000001
100000001100001100111C011C0001101C10110000C1100000001100000001
10000000110000110000000111000111000111000011100000001100000001
10000000000000000000000000000000000000000000000000000000000001
10000000000000000000000000000000000000000000000000000000000001
10111000111100111000011000011111100011111100111110001110001101
10011001C1100001100001100111C00011001C00000000001100C110001101
10011C10011000011110011000110000110001111001110011000110001101
10011100011000011C11C110001100001100000110011E0011000110001101
10011000011000111000111000110000110000111000111110000011111101
10000000000000000000000000000000000000000000000000000000000001
10000000000000000000111000000000000000000000000000000000000001
10000000000000000000011000000000000000000000000000000000000001
10000000000000000000000000000000000000000000000000000000000001
1000000000000000000C110000000000000000000000000000000000000001
10000000001110000000000000000000000000000000000000000000000001
1000000000C110011100110001111111000011111000011111000000000001
100000000001100C1100110011000001100110001100110001100000000001
10000000000110001100110011011001100CC0001100CC0001100000000001
10000000000110001100110011C01001100000001100000001100000000001
100000000001100001111000011100011000P0001100000011100000000001
10000000000000000000000000000000000000000000000000000000000001
11111111111111111111111111111111111111111111111111111111111111
