1111111111
10E00P0001
100C0C0001
1111111111