1111111111
100C0C0001
100P000E01
1111111111