1111111111
10000C0001
100P000E01
1111111111