11101111
1C000C01
1000E001
100C0P01
11111111
