1111111111
10E00P0001
1000000001
100C0C0001
1111111111