1111111111
1000000P01
100C010E01
1111111111
