11111111
10E00001
100100C1
101P1111
11111111
