11111111
10000001
100CEP01
11111111
